###########
#    #    #
#         #
#    #    #
#    #    #
## ###    #
#    ### ##
#    #    #
#         #
#    #    #
###########
