################
#         #    #
#    #    #    #
#    #    #    #
#    #    #    #
# ###### ##### #
#    #    #    #
#    #    #    #
#    #    #    #
#    #         #
# ##### ###### #
#    #    #    #
#    #    #    #
#    #    #    #
#    #    #    #
################
